111111111111111111111111111111111111111
100111111111111111111111111111111111111
10P0C1111111111111111111111111111111E01
100011111111111111111111111111111111111
111111111111111111111111111111111111111