1111111111111111111111111111111111
11000000000000C00000C0000000000011
1P0e00100C01C10000000000000E0000C1
1111111111111111111111111111111111
